{
  "3": 8,
  "4": 6,
  "1": 6,
  "90": 4,
  "89": 4,
  "62": 4,
  "95": 4,
  "94": 3,
  "5": 3,
  "65": 3,
  "55": 3,
  "96": 3,
  "2": 3,
  "107": 3,
  "47": 2,
  "71": 2,
  "63": 2,
  "93": 2,
  "59": 2,
  "15": 2,
  "171": 2,
  "108": 2,
  "60": 2,
  "48": 2,
  "61": 2,
  "41": 2,
  "69": 2,
  "53": 2,
  "196": 2,
  "38": 2,
  "44": 2,
  "34": 2,
  "6": 2,
  "88": 1,
  "10": 1,
  "86": 1,
  "56": 1,
  "54": 1,
  "64": 1,
  "98": 1,
  "52": 1,
  "173": 1,
  "51": 1,
  "9": 1,
  "7": 1,
  "11": 1,
  "33": 1,
  "66": 1,
  "197": 1,
  "58": 1,
  "12": 1,
  "92": 1,
  "14": 1,
  "70": 1,
  "68": 1,
  "195": 1,
  "97": 1,
  "20": 1,
  "154": 1,
  "22": 1,
  "24": 1,
  "174": 1,
  "16": 1,
  "76": 1,
  "39": 1,
  "146": 1,
  "28": 1,
  "193": 1,
  "49": 1,
  "118": 1,
  "116": 1,
  "110": 1,
  "42": 1,
  "211": 1,
  "78": 1,
  "30": 1,
  "190": 1,
  "109": 1,
  "101": 1,
  "175": 1,
  "23": 1,
  "75": 1,
  "17": 1,
  "43": 1,
  "57": 1,
  "91": 1,
  "85": 1,
  "87": 1
}